9,5,x,x,x,2,x,6,7
4,7,2,x,x,x,1,x,3
x,3,8,9,x,x,x,2,4
x,x,7,2,x,x,x,3,5
3,x,x,5,8,1,x,7,x
x,x,x,x,x,3,9,x,x
x,2,x,8,x,x,x,x,x
x,8,9,x,7,x,x,1,2
x,x,6,x,2,x,3,5,8